**********
*P   *   *
*        *
*     ** *
*        *
* **     *
*        *
*   M  *M*
*       G*
**********