**********
*P   *   *
*        *
*        *
*        *
*        *
*        *
*       M*
*       G*
**********